11111111
100011E1
10C00001
101P1101
11111111
